##########################################
#........................................#
#........................................#
#........................................#
#........................................#
#..................................#######
#..................................#######
########.................................#
########.................................#
########............................##...#
########...........................####..#
#........................................#
#........................................#
##########################################