####################
#..................#
#..................#
#..................#
#..................#
#..................#
#..................#
#....#########.....#
#........#...#.....#
#....#...#.........#
#....#########.....#
#....#...#.........#
#....#...#...#.....#
#....##.######.....#
#..................#
#..................#
#..................#
#..................#
#..................#
##################.#
